18 18 18 18 18 18 18 18 18 18 18 18 18 18 18 18 18 18 18 18 18 18 18 18 18 18 18 18 18 18 18 18 18 18 18 18 18 18 18 18 18 18 18 19 18 18 18 18 18 18 18 18 18 18 18 18 18 18 18 18 18 19 18 18 18 18 18 18 18 18 18 18 18 18 18 18 18 18 18 18 18 18 18 18 18 18 19 18 19 18 18 18 18 18 18 18 18 18 18 19 
18 18 18 18 18 18 18 18 18 18 18 18 18 18 18 18 18 18 18 18 18 18 18 18 18 18 18 18 18 18 18 18 18 18 18 18 18 18 18 18 18 18 18 18 18 19 18 19 18 18 18 18 18 18 18 18 18 18 18 18 18 18 18 18 18 18 18 18 18 18 18 18 19 18 18 18 18 18 18 18 18 18 18 19 18 18 18 18 19 18 18 18 18 18 18 18 18 18 18 19 
18 18 18 18 18 18 18 18 18 18 18 18 18 18 18 18 18 18 18 18 18 18 18 18 18 18 18 18 18 18 18 18 18 18 18 18 18 18 18 18 18 18 18 18 18 18 18 18 18 18 18 18 18 18 18 18 18 18 18 18 18 18 18 18 18 18 18 18 18 18 18 18 18 18 18 18 18 18 18 18 18 19 18 18 18 18 19 18 18 18 18 18 18 18 18 18 18 18 18 19 
18 18 18 18 18 18 18 18 18 18 18 18 18 18 18 18 18 18 18 18 18 18 18 18 18 18 18 18 18 18 18 18 18 18 18 18 18 18 18 18 18 18 18 18 18 18 18 18 18 18 18 18 19 18 18 18 18 18 18 18 18 18 18 18 18 18 18 18 18 18 18 18 18 18 18 18 18 18 18 18 18 18 18 18 18 18 18 18 18 18 18 18 18 18 18 18 18 18 18 18 
18 18 18 18 18 18 18 18 18 18 18 18 18 18 18 18 18 18 18 18 18 18 18 18 18 18 18 18 18 18 18 18 18 18 18 18 18 18 18 18 18 18 18 18 18 18 18 18 18 18 18 18 18 18 18 18 19 18 18 18 18 18 18 18 18 18 18 18 18 18 18 18 18 18 18 18 18 18 18 18 18 18 18 18 18 18 18 18 18 18 18 18 18 18 18 18 18 18 18 18 
18 18 18 18 18 18 18 18 18 18 18 18 18 18 18 18 18 18 18 18 18 18 18 18 18 18 18 18 18 18 18 19 18 18 18 18 18 18 18 18 18 18 18 18 18 18 18 18 18 18 18 18 18 18 18 18 18 18 18 18 18 19 18 18 18 18 18 18 18 18 18 18 18 18 18 18 18 18 18 18 19 18 18 18 18 18 18 18 18 18 18 18 18 18 18 18 18 18 18 18 
18 18 18 18 18 18 18 18 18 18 18 18 18 18 18 18 18 18 18 18 18 18 18 18 18 18 18 18 18 18 19 19 18 18 18 18 18 18 18 18 18 18 18 18 18 18 18 18 18 18 18 18 18 18 18 18 18 18 18 18 18 18 18 18 18 19 18 18 18 18 18 18 18 18 18 18 18 18 18 18 18 18 18 18 18 18 18 18 18 18 18 18 18 18 18 18 18 18 18 18 
18 18 18 18 18 18 18 18 18 18 18 18 18 18 18 18 18 18 18 18 18 18 18 18 18 18 18 18 18 18 19 19 19 19 18 19 19 18 18 18 18 18 18 18 18 18 18 18 19 18 18 18 18 18 18 18 18 18 18 18 19 18 18 18 18 18 18 18 18 18 18 18 18 18 18 18 18 18 18 18 18 18 18 18 18 18 18 18 18 18 18 18 18 18 18 18 18 18 18 19 
18 18 18 18 18 18 18 18 18 18 18 18 18 18 18 18 18 18 18 18 18 18 18 18 18 18 18 18 18 18 19 18 18 18 19 18 18 18 18 18 19 18 18 18 18 18 18 18 18 18 18 18 18 18 18 18 18 18 18 18 18 19 18 18 18 18 18 18 18 18 18 18 19 18 18 19 18 18 18 18 19 18 18 18 18 18 18 18 18 18 18 18 18 18 19 18 18 18 18 19 
18 18 19 18 18 19 18 18 18 18 18 18 18 18 18 18 18 18 18 18 18 19 18 18 18 18 18 18 18 18 18 19 19 18 18 19 18 18 18 18 18 18 18 18 18 19 18 18 18 18 18 18 18 18 18 18 18 18 18 18 19 18 18 18 18 18 18 18 18 18 18 18 18 18 18 18 19 18 18 18 18 18 18 18 18 18 19 18 18 18 18 18 18 18 19 19 19 19 18 19 
18 19 18 18 18 18 18 18 19 19 18 18 18 18 18 18 19 19 18 18 18 18 18 18 19 18 18 18 18 18 18 18 18 18 18 18 18 19 18 18 18 18 18 18 18 18 18 18 18 18 18 18 18 18 18 18 18 18 18 18 18 18 18 18 18 18 18 18 18 18 18 18 18 18 18 18 18 18 18 18 19 19 18 18 18 18 18 18 19 19 18 19 18 19 18 18 18 18 18 19 
18 19 18 18 18 18 18 18 18 18 18 18 18 18 18 18 18 18 18 18 18 18 18 18 18 18 19 18 18 18 18 18 19 18 18 18 18 18 18 18 18 18 18 18 18 18 18 18 18 18 18 18 18 18 18 18 18 18 18 18 18 18 18 19 18 18 18 18 18 18 19 19 18 19 19 18 18 18 18 18 18 18 19 19 19 19 18 18 18 18 18 18 19 18 18 18 19 18 18 19 
18 18 18 18 18 18 18 18 18 18 18 18 18 18 19 18 18 18 18 18 18 18 18 18 18 18 18 18 18 18 18 18 18 18 18 18 18 18 18 18 18 19 18 18 18 18 18 18 19 18 18 18 18 18 18 18 18 19 18 18 18 18 18 18 18 18 18 18 18 18 18 18 18 18 18 18 18 18 18 19 18 18 18 18 19 18 18 19 19 18 18 18 18 18 18 18 19 18 18 19 
18 18 18 18 19 18 18 18 18 18 18 18 18 18 18 18 18 18 18 18 19 18 18 18 18 18 18 18 18 18 18 18 18 18 19 18 18 18 18 18 19 18 18 18 18 18 18 18 18 19 18 18 18 18 18 18 18 18 18 18 19 18 18 18 18 18 18 18 18 18 18 18 18 18 18 18 18 18 18 18 18 19 18 18 18 18 18 18 19 18 18 19 18 18 19 18 19 18 18 19 
18 18 18 18 18 18 18 18 19 19 18 18 18 18 18 18 18 19 18 18 18 18 18 18 18 18 18 18 18 18 18 18 18 18 18 18 18 18 18 18 18 18 18 18 19 18 18 18 18 18 18 18 19 18 18 19 18 19 18 18 18 18 18 18 18 18 18 18 18 18 19 18 18 18 18 18 18 18 18 18 18 18 18 19 18 18 18 18 18 19 19 19 19 18 19 19 18 19 18 19 
18 18 18 19 19 18 19 18 18 18 18 18 18 18 19 18 18 18 18 18 18 18 18 18 18 18 18 18 19 18 18 18 18 18 19 18 18 18 18 18 18 19 18 19 18 18 18 18 19 18 18 19 18 18 18 18 18 18 18 18 18 18 18 18 18 18 18 18 18 18 18 18 18 18 18 18 18 18 18 18 18 18 18 18 18 18 18 18 18 19 18 18 18 18 18 18 18 18 18 19 
18 18 18 18 18 19 19 18 18 18 18 19 19 18 18 18 18 19 18 18 19 18 18 18 18 18 18 18 18 18 18 18 18 18 18 18 18 18 18 18 19 19 18 19 18 18 18 18 18 19 18 18 19 19 18 19 19 19 18 18 18 18 18 18 18 18 18 18 18 18 18 18 18 18 18 18 18 18 18 18 18 19 18 18 18 18 18 18 19 19 18 18 18 18 19 18 18 18 18 19 
18 18 18 18 18 19 18 19 18 18 19 18 18 18 18 19 18 18 18 19 18 19 18 18 18 18 18 18 18 18 18 19 18 18 19 18 18 18 19 19 19 19 18 18 18 18 18 19 18 18 18 19 19 19 18 18 18 18 18 18 18 18 18 18 18 19 18 19 18 18 19 18 18 18 18 18 18 19 18 18 19 18 18 18 18 18 18 18 19 18 18 19 18 18 18 18 19 18 18 19 
18 18 18 18 18 19 18 18 18 19 18 18 18 18 19 18 19 18 18 19 18 19 19 18 18 18 18 18 18 18 19 18 18 18 18 18 18 18 18 18 18 18 18 18 18 18 18 18 18 18 18 19 18 18 18 18 18 18 18 18 18 18 18 18 18 18 18 18 18 18 18 18 19 18 18 18 18 18 18 18 18 18 18 18 18 18 18 18 18 19 19 18 18 18 18 18 18 18 18 19 
18 18 18 19 18 18 18 18 18 18 18 19 18 18 18 18 18 19 19 18 18 19 18 18 18 18 18 18 18 18 18 18 18 18 18 18 18 18 18 18 18 18 18 18 19 18 18 18 18 19 19 18 18 18 18 18 18 18 18 18 19 18 18 18 18 18 18 18 18 18 19 18 18 18 18 18 18 18 18 18 18 19 18 18 18 18 18 18 19 18 18 18 18 19 19 19 18 18 18 19 
18 18 18 19 19 18 18 18 18 18 18 18 18 18 18 18 18 18 19 18 18 19 19 19 18 18 19 18 18 18 18 18 18 18 18 18 18 19 19 19 18 19 18 18 18 18 18 18 19 18 18 18 18 18 18 18 18 18 18 18 18 18 18 18 19 18 18 18 18 18 18 19 18 19 18 18 18 18 18 18 18 18 19 18 18 18 18 18 18 18 19 19 18 19 18 18 18 18 18 19 
18 18 18 19 19 18 18 18 18 18 18 19 19 19 19 18 18 19 19 19 19 18 18 19 18 18 18 18 18 18 18 18 18 18 19 19 19 18 18 19 19 19 19 19 19 19 18 18 18 18 18 19 18 18 18 18 19 19 18 18 18 19 18 18 18 18 18 19 18 19 18 18 18 18 18 18 18 18 19 18 18 19 18 18 18 18 18 18 18 18 19 18 19 19 18 18 18 18 18 19 
18 19 18 18 18 19 19 18 18 18 18 18 18 18 18 18 18 19 19 18 19 18 18 18 19 18 18 18 19 19 18 18 18 18 19 18 19 19 18 19 18 19 19 18 18 18 18 18 18 18 18 18 18 19 18 18 18 19 18 18 18 18 18 18 18 18 18 18 18 19 18 18 18 19 18 18 18 18 18 18 18 18 18 18 18 18 18 18 18 19 19 19 19 18 18 18 18 18 18 19 
19 18 18 18 19 18 19 18 18 18 18 18 19 18 19 18 18 18 19 28 26 26 26 26 26 26 26 26 26 26 26 26 26 26 26 26 26 26 26 26 26 26 26 26 26 26 26 26 26 26 26 26 26 26 26 26 26 26 26 26 26 26 26 26 26 26 26 26 26 26 26 26 26 26 26 26 26 26 26 26 26 26 26 26 29 19 19 18 18 18 19 19 18 18 18 19 18 18 19 19 
18 18 18 18 18 18 18 18 19 19 19 18 19 18 18 18 18 18 18 24 1 1 1 1 1 1 1 1 1 1 1 1 1 1 1 1 1 1 1 1 1 1 1 1 1 1 1 1 1 1 1 1 1 1 1 16 16 16 16 16 16 16 16 16 16 16 16 16 16 16 16 16 16 16 16 1 1 1 1 1 1 1 1 1 23 18 18 19 19 18 18 18 18 18 18 19 18 19 18 19 
18 18 18 18 18 18 18 18 18 18 18 19 19 18 18 19 18 18 18 24 1 1 1 1 1 1 1 1 1 1 1 1 1 1 1 1 1 1 1 1 1 1 1 1 1 1 1 1 1 1 1 1 1 1 16 16 16 16 16 16 16 16 16 16 16 16 16 16 16 16 16 16 16 16 16 16 1 1 1 1 1 1 1 1 23 18 18 18 19 18 18 18 18 18 18 18 18 18 18 19 
18 18 18 18 18 18 18 18 18 18 18 19 19 18 19 19 18 18 19 24 1 1 1 1 1 1 1 1 1 1 1 1 1 1 1 1 1 1 1 1 1 1 1 1 1 1 1 1 1 1 1 1 1 1 16 16 16 16 16 16 16 16 16 16 16 16 16 16 16 16 16 16 16 16 16 16 16 1 1 1 1 1 1 1 23 18 18 18 18 18 18 18 18 18 18 18 18 19 18 19 
19 18 19 18 18 18 19 19 19 18 18 18 18 18 18 18 18 18 18 24 1 1 1 1 1 1 1 1 1 1 1 1 1 1 1 1 1 1 1 1 1 1 1 1 1 1 1 1 1 1 1 1 1 16 16 1 16 16 1 1 2 1 1 2 1 1 1 1 1 1 1 1 2 16 16 16 16 16 16 16 1 1 1 1 23 18 18 18 18 18 18 18 18 18 18 18 18 18 18 19 
18 19 19 18 18 18 18 18 18 18 18 19 19 18 18 18 18 18 18 24 1 1 1 1 1 16 16 16 16 1 1 1 1 1 1 1 1 1 1 1 1 1 1 1 1 1 1 1 1 1 1 16 16 16 16 16 1 1 1 1 1 3 3 3 3 3 3 3 3 3 1 1 1 1 16 16 16 16 16 16 1 1 1 1 23 18 18 18 18 18 18 18 18 18 18 18 18 18 18 19 
18 18 18 18 18 18 18 19 19 19 19 18 18 18 18 19 18 18 19 24 1 1 1 1 1 16 16 16 16 16 16 16 1 16 1 1 1 1 1 16 16 16 1 1 16 1 16 1 16 1 16 16 16 16 1 16 1 3 3 3 3 3 1 2 2 34 34 34 34 3 3 1 1 1 16 16 16 16 16 16 1 1 1 1 23 18 18 18 18 18 18 18 18 18 18 18 18 18 18 19 
18 18 18 18 18 18 18 19 18 18 19 18 18 18 19 19 18 18 18 24 1 1 1 1 1 1 16 16 16 16 16 16 16 16 16 16 16 16 16 16 16 1 16 16 16 16 16 16 16 16 16 16 16 16 16 16 1 3 1 20 22 1 2 1 20 22 34 34 34 1 3 3 1 16 16 16 16 16 16 16 1 1 1 1 23 18 18 18 18 18 18 18 18 18 18 18 18 18 18 19 
18 18 18 18 18 18 18 18 18 18 18 19 18 18 19 18 19 19 19 24 1 1 1 1 1 1 16 16 16 16 16 16 16 16 16 16 16 16 16 16 16 16 16 16 16 16 16 16 16 16 16 16 16 16 16 1 3 1 1 23 30 21 21 21 31 24 34 35 20 22 1 3 1 16 16 16 16 16 16 16 1 1 1 1 23 18 18 18 18 18 18 18 18 19 18 18 18 18 19 19 
18 18 18 18 18 18 18 18 18 18 18 19 18 18 18 18 19 18 18 24 1 1 1 1 1 1 16 16 16 16 16 16 16 16 16 16 16 16 16 16 16 16 16 16 16 16 16 16 16 16 16 16 16 16 16 3 1 1 1 23 18 18 18 18 18 24 34 34 23 24 1 3 1 16 16 16 16 16 16 16 1 1 1 1 23 18 18 18 18 18 18 18 18 18 18 18 18 18 19 19 
18 18 18 18 18 18 18 18 18 18 18 18 19 18 18 18 18 18 19 24 1 1 1 1 1 1 1 16 16 16 16 16 16 16 16 16 16 16 16 16 16 16 16 16 16 16 16 16 16 16 16 16 16 1 1 3 20 21 21 31 18 18 18 18 18 24 34 34 23 24 1 3 3 1 16 16 16 16 16 16 1 1 1 1 23 18 18 19 18 18 18 18 18 18 18 18 19 18 18 19 
18 18 18 18 18 18 18 18 18 19 19 19 19 18 18 18 18 19 18 24 1 1 1 1 1 1 1 16 16 16 16 16 16 16 16 16 16 16 16 16 16 16 16 16 16 16 1 1 1 16 16 16 16 1 3 1 23 18 18 18 18 18 18 18 18 30 21 21 31 24 1 1 3 1 16 16 16 16 16 16 16 1 1 1 23 18 18 18 18 18 19 18 18 18 18 19 18 18 18 19 
19 19 19 18 18 18 18 18 18 18 19 18 18 18 18 18 19 18 18 24 1 1 1 1 1 1 1 1 16 16 16 16 16 16 16 16 16 16 16 16 16 16 16 16 16 16 1 1 1 16 16 16 1 1 3 1 23 18 18 18 18 18 18 18 18 18 18 18 28 27 1 1 3 1 1 16 16 16 16 16 16 1 1 1 23 18 18 18 18 18 18 18 18 18 18 18 18 18 18 19 
18 18 18 18 18 18 18 18 18 18 18 19 18 19 19 19 18 18 18 24 1 1 1 1 1 1 1 1 1 16 16 16 16 16 16 16 16 16 16 16 16 16 16 16 16 16 1 1 1 16 16 16 16 1 3 1 23 18 18 18 18 18 18 18 18 18 18 18 24 1 1 1 3 2 2 1 16 16 16 16 16 1 1 1 23 18 18 18 18 18 18 18 18 18 18 18 18 18 18 19 
18 18 18 18 18 18 18 18 18 18 18 18 19 18 19 18 18 18 18 24 1 1 1 1 1 1 1 1 1 16 16 16 16 16 16 16 16 16 16 16 16 16 16 1 1 1 1 1 1 1 16 16 16 16 1 3 23 18 18 18 18 18 18 18 18 18 18 18 24 1 1 1 3 1 2 1 16 16 16 16 16 1 1 1 23 18 18 18 18 18 18 18 18 18 19 18 18 18 18 19 
18 18 18 18 18 18 18 18 18 18 19 19 19 19 19 19 19 18 19 24 1 1 1 1 1 1 1 1 16 16 16 16 16 32 32 33 32 32 16 16 16 16 1 1 1 2 1 1 1 1 16 16 16 16 1 3 25 26 26 26 29 18 18 18 18 18 18 18 30 22 1 1 3 1 1 16 16 16 16 16 16 1 1 1 23 18 18 18 18 18 18 18 18 18 18 18 18 18 18 18 
18 18 18 18 18 18 18 18 18 18 18 18 18 18 19 19 18 18 18 24 1 1 1 1 1 1 1 1 16 16 16 16 32 1 6 3 4 1 32 32 16 32 1 1 1 2 1 2 1 1 1 16 16 16 1 3 1 1 1 2 23 18 18 18 18 18 18 18 18 30 22 1 3 2 1 16 16 16 16 16 1 1 1 1 23 18 18 18 18 18 18 18 18 18 18 18 18 18 18 18 
18 18 18 18 18 18 18 18 18 18 18 18 18 18 18 19 19 19 18 24 1 1 1 1 1 1 1 1 1 16 16 16 32 1 8 3 7 1 1 1 32 1 1 1 1 1 1 1 1 1 1 1 16 16 1 3 3 1 1 2 23 18 18 18 18 18 18 18 18 28 27 1 3 1 1 16 16 16 16 16 1 1 1 1 23 18 19 18 18 18 18 18 18 18 18 18 18 18 18 18 
18 18 18 18 18 18 18 18 18 18 18 18 18 19 18 18 18 19 19 24 1 1 1 1 1 1 1 16 16 16 32 32 1 1 8 3 7 1 1 2 1 1 1 1 1 1 1 1 1 1 1 1 16 16 16 1 1 3 3 1 25 26 26 29 18 18 28 26 26 27 1 3 1 1 16 16 16 16 16 1 1 1 1 1 23 18 18 18 18 19 18 18 18 18 19 18 18 18 18 18 
18 18 18 18 18 18 18 18 18 18 18 18 18 18 18 18 18 18 18 24 1 1 1 1 1 1 1 1 1 1 1 1 1 1 8 3 7 1 1 2 1 1 1 2 2 1 1 1 1 1 1 1 16 16 16 1 1 1 1 3 1 1 1 23 18 18 24 1 1 1 3 1 1 2 16 16 16 16 16 1 1 1 1 1 23 18 18 18 18 18 18 18 18 19 19 18 18 18 18 18 
18 18 18 18 18 18 18 18 18 18 18 18 18 18 18 18 18 18 18 24 1 1 1 1 1 1 1 1 1 2 2 1 1 1 8 3 7 1 1 1 1 1 1 1 2 1 1 1 1 1 1 1 1 16 16 16 1 1 1 3 3 3 1 25 26 26 27 1 3 3 1 1 16 16 16 16 16 16 16 1 1 1 1 1 23 18 18 18 18 18 18 18 18 19 18 18 19 18 18 18 
18 18 18 18 18 18 18 18 18 18 18 18 18 18 18 19 19 18 18 24 1 1 1 1 1 1 1 1 1 1 2 1 1 1 8 3 7 1 1 1 2 1 1 1 1 2 1 1 1 1 1 1 1 16 16 16 16 16 16 1 1 3 3 3 3 10 3 3 3 1 16 16 16 16 16 16 16 1 1 1 1 1 1 1 23 18 18 18 18 18 18 18 19 18 18 18 19 18 18 18 
18 18 18 18 18 18 18 19 18 19 18 18 18 18 18 18 19 18 18 24 1 1 1 1 1 2 1 1 1 1 2 1 1 1 8 3 7 1 1 1 2 1 1 1 1 2 1 1 1 1 1 1 1 1 16 16 16 16 16 16 16 16 16 8 3 3 1 1 1 16 16 16 16 16 16 16 16 1 1 1 1 1 1 1 23 18 18 18 18 19 18 18 19 18 18 18 18 18 18 18 
18 18 18 18 18 18 18 18 18 18 18 18 18 18 18 18 18 19 19 24 1 1 1 1 1 1 1 1 1 1 2 1 1 1 8 3 7 1 1 1 1 1 1 1 2 1 1 1 1 1 1 1 1 1 1 16 16 16 1 1 1 16 1 8 3 4 16 16 16 16 16 16 16 16 16 1 1 1 1 1 2 1 1 1 23 18 18 18 18 18 19 19 19 18 18 18 19 18 18 18 
18 18 18 18 18 18 19 18 18 18 18 18 18 18 18 19 18 18 18 24 1 1 1 1 1 2 1 1 1 2 1 1 1 1 8 3 9 10 10 10 10 10 10 10 10 10 10 10 10 10 10 10 10 10 10 10 10 10 10 10 10 10 10 11 3 7 16 1 1 1 1 1 1 1 1 1 1 1 2 2 1 1 1 1 23 19 19 18 19 18 18 18 19 18 18 18 19 18 18 18 
18 18 18 18 18 18 18 18 18 18 18 18 18 18 18 19 19 18 18 24 1 1 1 1 1 1 1 1 1 2 2 1 1 1 8 3 3 3 3 3 3 3 3 3 3 3 3 3 3 3 3 3 3 3 3 3 3 3 3 3 3 3 3 3 3 7 16 1 1 1 1 1 1 1 1 1 1 2 1 2 1 1 1 1 23 18 18 18 19 18 18 18 18 18 18 18 18 18 18 18 
18 18 18 18 18 18 18 18 18 18 18 18 18 18 18 18 18 18 18 24 1 1 1 1 1 1 1 1 1 1 2 2 1 1 8 3 4 5 5 5 5 5 5 5 5 5 5 5 5 5 5 5 5 5 5 5 5 5 5 5 5 5 5 5 5 15 16 1 1 1 1 1 1 1 1 1 1 2 2 1 1 1 1 1 23 19 18 18 18 18 18 19 18 18 18 18 18 18 18 18 
18 18 18 18 18 18 19 18 18 18 18 18 18 18 18 18 18 19 18 24 1 1 1 2 1 1 1 1 2 2 1 1 1 1 8 3 7 1 1 2 2 1 1 1 1 1 1 1 1 1 1 1 1 1 1 1 1 1 1 1 1 1 1 1 1 1 1 1 1 1 1 1 1 1 1 1 1 1 2 1 1 1 1 1 23 19 18 18 19 19 18 19 19 19 18 18 18 18 18 18 
18 18 18 18 18 18 18 18 18 18 18 18 18 18 18 18 18 18 18 24 1 1 1 2 2 2 1 1 1 1 1 2 1 1 8 3 7 1 1 1 1 2 1 1 1 1 1 1 1 1 1 1 1 1 1 1 1 1 1 1 1 1 1 1 1 1 1 1 1 1 1 1 2 2 1 1 1 1 1 2 1 1 1 1 23 18 18 18 18 18 18 18 18 18 18 18 19 18 18 18 
18 18 18 18 18 18 18 18 18 18 18 19 18 19 18 18 18 18 18 24 1 1 1 2 1 1 1 1 1 1 1 1 1 1 8 3 7 1 1 2 1 1 1 1 1 1 1 1 1 1 1 1 1 1 1 1 1 1 16 16 1 1 1 1 1 1 2 2 1 1 1 1 1 1 1 1 1 1 1 1 1 1 1 1 23 18 18 18 18 18 18 18 18 18 18 19 19 18 18 18 
18 18 18 18 18 18 18 18 18 18 18 18 18 18 18 18 18 18 18 24 1 1 1 2 1 1 1 1 1 1 1 1 1 1 11 3 9 1 1 1 1 1 1 34 34 34 34 34 34 34 34 34 34 34 34 34 34 1 16 16 16 1 1 1 1 1 2 1 1 1 1 1 1 1 1 1 1 1 1 1 1 1 1 1 23 18 18 18 18 18 18 18 18 19 18 18 18 18 18 18 
18 18 18 18 18 18 18 18 18 18 18 18 18 18 18 18 18 18 18 24 1 1 1 1 1 1 16 16 16 16 34 34 34 34 34 34 34 34 34 34 34 34 34 34 1 34 34 1 34 34 34 1 34 34 34 1 34 34 16 16 16 16 1 1 1 1 2 1 1 1 1 1 1 17 17 17 17 17 1 1 1 1 1 1 23 18 18 18 18 18 18 18 18 18 18 19 18 18 18 18 
18 18 18 18 18 18 18 18 18 18 18 18 18 18 18 18 18 18 18 24 1 1 1 1 1 1 16 16 16 16 1 1 1 34 34 34 34 1 34 34 34 34 34 34 34 34 34 34 34 34 34 34 34 34 34 34 1 34 34 16 16 16 1 1 1 1 2 1 1 1 1 1 1 17 1 1 1 17 17 1 1 1 1 1 23 18 18 18 18 18 18 18 18 18 18 19 18 18 18 19 
18 18 18 18 18 18 18 18 18 18 18 18 18 18 18 18 18 18 18 24 1 1 1 1 16 16 16 16 16 16 1 34 34 34 1 34 34 34 34 1 1 34 34 34 1 34 34 34 34 34 34 34 34 34 34 34 34 34 34 16 16 16 1 1 1 1 2 1 1 1 1 1 1 17 1 1 1 1 17 17 1 1 1 1 23 18 18 18 18 18 18 18 18 18 19 18 18 18 18 18 
18 18 18 18 18 18 18 18 18 19 18 18 19 18 18 18 18 18 18 24 1 1 16 16 16 16 16 16 16 16 1 34 34 34 1 34 1 34 34 34 34 34 1 34 34 34 34 34 34 34 34 34 34 34 34 1 34 34 1 16 16 16 1 1 1 1 2 1 1 1 1 1 1 17 1 1 1 17 17 17 1 1 1 1 23 19 18 18 19 19 18 18 19 18 19 18 18 18 18 18 
18 18 18 18 18 18 18 18 18 18 18 18 18 18 18 18 18 18 18 24 1 1 16 16 16 16 16 16 16 16 34 34 34 34 34 34 34 34 34 34 34 34 34 34 34 34 34 34 34 34 34 34 34 34 34 34 34 1 16 16 16 16 16 1 1 1 2 1 1 17 17 17 17 17 17 17 17 17 1 1 17 17 1 1 23 18 18 18 18 18 19 19 18 18 19 18 18 18 18 18 
18 18 18 18 18 18 18 18 18 18 18 18 18 18 18 18 18 18 18 24 1 1 16 16 16 16 16 16 16 1 34 34 34 34 34 1 34 34 1 1 1 34 34 1 1 34 34 34 34 34 34 34 34 34 1 34 34 16 16 16 16 16 16 1 1 1 2 1 1 17 17 17 1 17 17 17 17 17 17 17 1 17 1 1 23 18 18 18 18 18 18 19 18 18 18 18 18 18 18 18 
18 18 18 18 18 18 19 18 18 18 18 18 18 18 19 18 18 18 18 24 1 1 1 16 16 16 16 16 16 1 34 34 34 1 34 34 34 1 1 34 34 34 34 34 34 34 34 34 1 34 34 34 34 1 34 34 1 16 16 16 16 16 16 1 1 1 2 1 17 17 17 17 1 17 1 17 17 17 17 17 1 17 1 1 23 18 18 18 18 18 18 19 18 18 18 18 18 18 18 18 
18 18 18 18 18 19 18 18 18 18 18 18 18 18 18 18 18 18 18 24 1 1 1 1 16 16 16 16 16 16 1 1 34 34 1 34 34 34 34 34 34 1 34 34 34 1 1 34 1 34 1 34 34 34 34 34 16 16 16 16 16 16 16 1 1 1 2 1 17 17 1 17 17 17 17 1 17 17 17 17 1 17 1 1 23 18 18 18 18 18 18 19 18 18 18 18 19 18 18 18 
18 18 18 18 18 18 18 18 18 18 18 18 19 18 18 18 18 18 18 24 1 1 1 1 1 16 16 16 16 16 16 16 1 34 34 34 1 1 34 34 34 34 34 34 34 34 1 34 34 34 1 34 34 34 34 1 16 16 16 16 16 16 16 1 1 2 2 1 1 17 1 17 17 1 17 17 17 17 1 17 17 17 17 1 23 18 18 18 18 19 19 18 18 18 18 18 19 18 18 18 
18 18 18 18 18 18 18 18 18 18 18 18 18 18 18 18 18 18 18 24 1 1 1 1 1 16 16 16 16 16 16 16 16 16 16 16 16 16 16 1 1 1 1 1 34 34 34 34 34 34 34 34 16 16 16 16 16 16 16 16 16 16 16 1 2 2 1 1 1 17 17 17 17 1 1 17 17 17 1 1 17 1 17 1 23 18 18 19 19 18 18 18 18 19 19 18 18 18 18 18 
18 18 18 18 18 18 18 18 18 18 18 18 18 18 18 18 18 18 18 24 1 1 1 1 1 1 16 16 16 16 16 16 16 16 16 16 16 16 16 16 16 16 16 16 34 34 34 1 1 1 16 16 16 16 16 16 16 16 16 16 16 16 16 1 2 1 1 1 1 17 17 17 17 17 1 1 17 1 1 1 17 1 17 1 23 19 19 19 19 18 19 19 18 19 18 18 18 18 18 18 
18 18 18 18 18 18 18 18 18 18 19 18 18 18 18 18 18 18 18 24 1 1 1 1 1 16 16 16 16 16 16 16 16 16 16 16 16 16 16 16 16 16 16 16 16 16 16 16 16 16 16 16 16 16 16 16 16 16 16 16 16 1 1 1 2 1 1 1 1 17 17 17 17 17 17 1 17 17 1 1 17 1 17 1 23 18 18 18 18 18 18 18 18 18 18 18 18 18 18 18 
18 18 18 18 18 18 18 18 18 18 18 18 18 18 18 18 18 18 18 24 1 1 1 1 1 1 16 16 16 16 16 16 16 16 16 16 16 16 16 16 16 16 16 16 16 16 16 16 16 16 16 16 16 16 16 16 16 16 16 16 16 16 1 1 2 1 1 1 17 17 17 17 17 1 17 1 1 17 1 1 17 1 17 1 23 18 18 18 18 18 18 18 18 18 18 18 18 18 18 18 
18 18 18 18 18 18 18 18 19 18 18 18 18 18 18 18 18 18 18 24 1 1 1 1 1 1 1 16 16 16 16 16 16 16 16 16 16 16 16 16 16 16 16 16 16 16 16 16 16 16 16 16 16 16 16 16 16 16 16 16 16 16 1 1 2 1 1 17 1 17 17 17 17 1 17 17 1 17 1 1 17 1 17 1 23 18 18 18 18 18 18 18 18 18 18 18 18 18 18 18 
18 18 18 18 18 18 18 18 18 18 18 18 18 18 19 18 18 18 18 24 1 1 1 1 1 1 1 1 1 1 1 16 16 1 16 16 16 16 16 16 16 16 16 16 16 16 16 16 16 16 16 16 16 16 16 16 16 16 16 16 16 1 1 1 2 1 1 17 1 17 1 1 1 1 1 17 17 17 1 1 17 17 1 1 23 18 19 18 18 18 18 18 18 18 19 18 18 18 18 18 
18 18 18 18 18 18 18 18 18 18 18 18 18 19 18 18 18 19 19 24 1 1 1 1 1 1 1 1 1 1 1 1 1 1 1 1 1 1 1 1 1 1 1 1 16 16 16 16 16 16 16 16 16 16 16 16 1 1 1 1 1 1 1 1 2 1 1 17 1 17 17 1 17 1 1 1 17 17 1 1 1 17 1 1 23 18 18 18 18 18 18 18 18 18 18 18 18 18 18 18 
18 18 18 18 18 18 18 18 18 18 19 18 18 18 18 18 18 18 18 24 1 1 1 1 1 1 1 1 1 1 1 1 1 1 1 1 1 1 1 1 1 1 1 1 1 1 1 16 16 16 16 16 16 16 1 1 1 1 1 1 1 1 1 2 1 1 1 17 1 17 17 1 17 1 17 17 17 17 17 17 17 17 1 1 23 18 18 18 18 18 18 18 18 18 18 18 19 19 18 18 
18 18 18 18 18 18 18 18 18 19 18 18 18 18 18 18 19 18 18 24 1 1 1 1 1 1 2 2 2 1 1 1 1 1 1 1 1 1 1 1 1 1 1 1 1 1 1 1 1 1 1 1 1 1 1 1 1 1 1 1 1 1 2 2 1 1 1 1 17 17 17 17 17 17 17 17 17 17 17 1 1 17 17 17 23 18 18 18 18 18 18 18 18 18 19 19 18 19 18 18 
18 18 18 18 18 18 18 18 19 18 18 18 18 18 18 18 19 18 19 24 1 1 1 1 1 2 2 1 2 2 2 2 2 2 2 1 1 1 1 1 2 2 2 1 1 1 1 1 1 1 1 1 1 1 1 1 1 1 1 1 1 2 2 1 1 1 1 1 1 17 17 17 17 17 17 17 17 1 17 17 1 1 17 17 23 18 18 18 19 18 19 19 18 18 18 18 18 18 18 18 
18 18 18 18 18 18 18 18 19 18 18 18 18 18 18 19 18 18 18 24 1 1 1 1 1 2 2 1 1 1 1 1 1 1 2 2 1 1 1 1 2 2 2 2 2 2 2 2 2 2 2 1 1 1 1 1 1 1 1 1 1 2 1 1 1 1 1 1 1 17 1 1 17 17 17 1 17 1 17 17 17 1 1 17 23 19 18 18 18 18 18 18 18 18 18 18 18 18 18 18 
18 18 18 18 18 18 19 18 18 18 18 18 18 18 18 19 18 18 18 24 1 1 1 1 1 1 2 2 2 1 1 1 1 1 1 2 2 2 2 2 2 1 1 1 1 1 1 1 1 1 2 2 2 2 2 2 2 2 2 2 2 2 1 1 1 1 1 1 1 17 17 1 17 17 1 17 17 17 1 1 17 17 1 1 23 18 18 18 19 18 18 18 18 19 18 18 18 18 18 18 
19 18 18 18 19 18 18 18 19 18 18 18 18 19 18 18 18 18 18 24 1 1 1 1 1 1 1 1 1 1 1 1 1 1 1 1 1 1 1 1 1 1 1 1 1 1 1 1 1 1 1 1 1 1 1 1 1 1 1 1 1 1 1 1 1 1 1 1 1 1 17 1 17 17 17 17 17 17 1 17 17 17 1 1 23 18 18 19 18 18 18 18 18 18 18 18 18 18 18 18 
19 18 19 18 18 18 18 18 18 18 19 18 19 18 18 18 19 18 18 24 1 1 1 1 1 1 1 1 1 1 1 1 1 1 1 1 1 1 1 1 1 1 1 1 1 1 1 1 1 1 1 1 1 1 1 1 1 1 1 1 1 1 1 1 1 1 1 1 1 1 17 1 1 1 1 17 17 17 17 17 1 17 17 1 23 19 18 18 18 18 18 18 19 18 18 18 18 18 18 18 
19 19 18 18 18 19 18 18 18 18 18 19 19 19 18 18 18 19 18 24 1 1 1 1 1 1 1 1 1 1 1 1 1 1 1 1 1 1 1 1 1 1 1 1 1 1 1 1 1 1 1 1 1 1 1 1 1 1 1 1 1 1 1 1 1 1 1 1 1 1 17 17 17 1 1 17 1 17 17 1 1 17 17 1 23 18 18 18 18 18 19 18 18 18 18 18 18 18 18 18 
18 18 18 18 18 18 18 18 19 19 18 19 19 19 19 18 19 19 19 24 1 1 1 1 1 1 1 1 1 1 1 1 1 1 1 1 1 1 1 1 1 1 1 1 1 1 1 1 1 1 1 1 1 1 1 1 1 1 1 1 1 1 1 1 1 1 1 1 1 1 1 1 17 17 17 17 17 17 1 1 17 17 17 17 23 18 19 19 18 18 18 18 19 18 18 18 18 18 18 18 
18 18 18 18 18 18 18 18 18 18 18 18 19 19 19 19 18 19 18 24 1 1 1 1 1 1 1 1 1 1 1 1 1 1 1 1 1 1 1 1 1 1 1 1 1 1 1 1 1 1 1 1 1 1 1 1 1 1 1 1 1 1 1 1 1 1 1 1 1 1 1 1 1 1 1 1 1 17 17 17 17 1 1 17 23 18 18 18 18 18 18 18 18 19 18 18 19 18 18 19 
18 18 18 18 18 19 19 19 19 19 19 19 18 19 19 18 18 18 18 30 21 21 21 21 21 21 21 21 21 21 21 21 21 21 21 21 21 21 21 21 21 21 21 21 21 21 21 21 21 21 21 21 21 21 21 21 21 21 21 21 21 21 21 21 21 21 21 21 21 21 21 21 21 21 21 21 21 21 21 21 21 21 21 21 31 18 19 18 18 19 18 19 18 19 18 19 19 18 18 18 
18 18 18 18 19 18 18 19 19 19 18 18 18 18 19 18 19 19 19 18 18 18 18 18 18 19 18 18 18 18 18 18 18 18 18 18 18 18 19 19 18 18 18 19 18 19 18 18 18 19 18 19 18 18 18 19 19 18 18 18 18 19 18 19 19 18 18 18 18 18 19 18 18 18 18 18 18 18 18 18 18 18 18 18 19 18 18 18 18 18 18 18 18 19 18 19 18 18 18 18 
18 18 18 18 18 18 19 18 18 18 18 18 19 18 18 19 18 18 18 18 19 18 18 18 18 18 19 19 18 18 18 18 18 18 18 19 18 18 18 19 18 18 18 18 19 18 18 18 18 18 18 19 19 18 18 18 19 18 18 18 18 18 18 18 18 18 18 18 18 18 18 18 19 18 18 18 18 18 18 18 18 19 19 19 19 19 18 19 19 18 18 18 18 18 19 19 18 18 18 18 
18 18 18 18 18 18 19 18 18 19 19 19 19 18 18 18 18 18 18 18 19 18 18 18 18 18 18 19 19 18 18 18 18 19 18 18 18 19 18 19 18 18 18 18 18 18 18 18 18 18 18 19 19 19 18 18 19 19 18 18 18 18 18 19 18 18 18 18 18 19 18 18 18 18 18 19 18 18 18 18 18 18 18 18 19 18 18 19 19 18 18 18 18 18 18 18 18 19 18 19 
18 18 18 19 18 18 19 18 19 18 18 18 18 18 18 18 18 18 18 18 18 18 19 18 18 18 18 18 18 18 18 18 18 18 18 18 18 18 18 18 18 18 18 18 18 18 18 19 18 18 18 18 18 18 18 18 19 18 18 19 18 18 18 18 19 19 18 18 18 18 18 18 18 18 18 18 18 18 18 18 18 18 18 19 18 19 18 18 19 18 18 18 18 18 18 18 18 18 18 19 
18 18 18 18 18 18 18 19 18 18 18 18 18 18 19 19 19 19 18 18 18 18 18 18 18 18 18 18 18 18 18 18 18 18 18 18 18 18 18 18 18 19 19 19 18 18 18 18 18 18 18 18 18 18 18 19 19 18 19 18 18 18 18 19 19 18 18 19 18 18 18 18 18 18 18 18 18 18 19 18 18 18 19 18 18 18 18 18 18 18 19 18 18 18 18 18 18 18 19 18 
18 18 18 18 19 18 18 18 18 18 18 18 18 18 18 18 18 18 18 18 18 18 18 18 18 18 18 18 18 18 18 18 18 19 19 19 18 18 18 18 18 18 18 19 19 18 18 18 18 19 19 18 18 18 18 19 18 18 18 19 18 18 18 18 18 18 18 18 18 18 19 18 18 18 18 18 18 19 18 19 18 18 18 18 18 18 18 18 18 18 19 18 19 18 19 18 18 18 18 18 
18 18 18 18 18 18 18 19 19 18 18 18 18 19 18 18 18 18 19 18 18 18 18 18 18 18 18 18 18 18 18 19 19 18 18 19 18 19 18 18 18 18 18 18 18 19 18 19 19 18 18 18 18 18 19 19 18 18 18 18 18 18 19 18 18 19 19 18 18 18 18 19 18 19 19 19 18 18 18 18 18 19 18 18 18 18 18 18 18 19 18 18 19 19 18 18 18 19 18 18 
18 18 18 18 18 18 18 18 19 18 18 18 18 18 18 18 19 18 18 18 18 18 18 18 18 18 18 19 18 18 19 18 18 18 18 18 18 19 19 18 18 19 18 18 18 18 19 18 18 18 18 18 19 19 19 18 18 18 18 18 18 18 18 18 18 18 18 18 18 18 18 18 18 18 19 18 19 18 18 18 18 18 18 18 18 18 19 18 18 19 19 19 19 19 18 18 18 18 18 18 
18 18 18 18 18 18 19 18 18 18 18 19 18 18 18 18 18 18 18 18 18 18 18 18 18 18 18 19 18 18 19 18 18 18 18 19 19 19 19 18 18 18 18 18 18 18 19 19 18 18 19 18 19 19 19 18 18 18 19 19 18 18 18 18 18 18 19 19 18 18 18 18 18 18 18 18 18 19 18 19 18 19 18 18 18 18 18 18 18 19 18 18 18 18 18 18 18 19 18 18 
18 18 18 18 18 18 18 19 19 19 19 19 18 18 18 18 18 18 18 18 18 18 18 18 18 18 18 18 18 18 19 19 19 19 19 19 18 18 19 19 19 19 19 19 19 19 18 19 19 18 18 18 19 19 18 18 19 18 18 18 18 18 18 18 19 19 18 18 18 19 18 18 18 18 18 19 18 18 18 18 18 19 18 18 18 18 18 19 19 18 18 18 18 18 18 18 18 19 18 18 
18 18 18 18 18 18 18 18 18 18 19 18 18 18 18 18 19 18 18 18 18 18 18 18 18 19 18 18 18 18 18 18 18 18 18 18 18 18 18 18 18 18 18 18 18 18 18 18 18 19 19 19 19 18 18 18 19 18 18 18 18 18 18 18 18 18 18 18 18 18 18 19 18 18 18 18 18 18 19 19 18 18 18 18 18 18 18 18 18 18 19 18 18 18 18 18 18 18 19 18 
18 18 18 18 18 18 18 18 18 18 18 18 18 18 19 18 18 18 18 18 18 18 18 18 18 19 19 18 18 18 18 18 18 18 18 18 18 18 18 18 18 18 18 18 18 19 18 19 18 18 18 18 18 18 18 18 18 18 18 18 18 18 18 18 19 18 18 18 18 18 18 18 18 18 19 18 19 18 19 18 18 18 18 18 19 18 18 18 18 19 18 18 18 18 18 18 18 19 18 19 
18 18 18 18 18 18 18 18 18 18 18 18 18 18 18 18 19 18 18 18 18 18 18 18 18 18 19 18 18 18 18 18 18 18 18 18 18 18 18 18 18 18 18 18 18 18 18 18 18 18 19 18 19 18 18 18 18 18 18 18 18 18 18 18 18 18 18 18 18 18 18 18 18 19 18 18 18 18 18 18 19 18 18 18 18 18 18 18 18 18 18 18 18 18 18 19 18 18 18 18 
18 18 18 18 18 18 18 18 18 18 18 18 18 18 18 18 18 18 18 19 18 18 18 18 18 18 19 18 18 18 18 18 18 18 18 18 18 18 18 18 18 18 18 18 18 18 18 18 18 18 18 19 18 18 18 18 18 18 18 18 18 18 18 18 18 18 18 18 18 18 18 18 18 18 19 18 18 18 18 18 18 18 18 18 18 18 18 18 18 19 18 18 18 18 18 18 18 18 18 18 
18 18 18 18 18 18 18 18 18 18 18 18 18 18 18 18 18 18 18 18 18 19 18 18 18 18 19 18 18 18 18 18 18 18 18 18 18 18 18 18 18 18 18 18 18 19 19 19 18 18 18 18 18 18 18 18 18 18 18 18 18 18 18 18 18 18 18 18 18 18 18 18 18 18 18 18 18 18 18 18 18 18 18 18 18 18 18 18 18 18 18 18 18 18 18 18 19 18 18 18 
18 18 18 18 18 18 18 18 18 18 18 18 18 18 18 18 18 18 18 18 18 18 18 19 19 19 19 18 18 18 18 18 18 18 18 18 18 18 18 18 18 18 18 18 18 18 18 18 18 18 18 18 18 18 19 18 18 18 18 18 18 18 19 18 18 18 18 18 19 18 18 18 18 18 18 18 18 18 18 18 18 18 18 18 18 18 18 18 18 18 18 18 18 19 18 18 18 18 18 18 
18 18 18 18 18 18 18 18 18 18 18 18 18 18 18 18 18 18 18 18 18 18 18 18 18 18 18 18 18 18 18 18 18 18 18 18 18 18 18 18 18 18 18 18 18 18 18 18 18 18 18 18 18 18 18 18 18 18 18 18 18 18 18 18 18 18 18 18 18 18 18 18 18 18 18 18 18 19 18 18 18 18 18 18 18 18 18 18 18 19 18 18 18 19 18 18 18 18 18 18 
18 18 18 18 18 18 18 18 18 18 18 18 18 18 18 18 18 18 18 18 18 18 18 18 18 18 18 18 18 18 18 18 18 18 18 18 18 18 18 18 18 18 18 18 18 18 18 18 18 18 18 18 18 18 18 18 18 18 18 18 18 18 18 18 18 18 18 18 18 18 18 19 18 18 18 18 18 18 18 18 18 18 18 18 18 18 18 18 18 18 18 18 18 18 18 18 18 18 18 18 
18 18 18 18 18 18 18 18 18 18 18 18 18 18 18 18 18 18 18 18 18 18 18 18 18 18 18 18 18 18 18 18 18 18 18 18 18 18 18 18 18 18 18 18 18 18 18 18 18 18 18 18 18 18 18 18 18 18 18 18 18 18 18 18 18 18 18 18 18 18 18 18 18 18 18 18 18 18 18 18 18 19 18 18 18 18 18 18 18 18 18 18 18 18 18 18 18 18 18 18 
